width(chiều ngang):19
height(chiều dọc):19
chú ý là phần bản đồ k để thừa khoảng trắng


||||| |||||||||||||
| |__ | _ |__  __ |
|__ | | |__ |__ |_|
| ___  _| |_| | __|
|_| |______ ___ | |
| ___ __| |_| _ _ |
|_| | |__ ____| |_|
|__ ___ | | |  __ |
| | |_____| |__ |_|
|____ |___________|